38
1,3,2,2,1,1,1,9,1,1
1,3,2,9,2,1,1,9,1,2
3,1,1,9,3,2,2,1,2,3
1,9,9,9,1,9,1,1,2,1
2,9,3,2,2,9,9,9,9,9
1,2,2,1,2,3,9,3,2,1
1,2,9,9,1,9,9,1,2,1
1,9,9,1,2,9,1,2,9,2
3,1,9,1,1,1,2,1,9,0
1,2,9,2,2,2,9,2,3,3